                                     @@@%%####%@@@                                                  
                                   @@#***+++******#@@                                               
                                 *@#*++*****#%%%%#**#@@                                             
                                =@#++******#%%%%%@%#*#@@                                            
                                @@*+*******####%%%%%#*#@@                                           
                                @%++*****#######%%%%%**@@                                           
                               @@*++*****#########%%%**%@                                           
                       %@@@@@@@@%*++************####*+#@@                                           
                @@@%##********#*+++++***************+*%@@                                           
            @@%#**************++++++++++*********+++*%@=                                            
         @@%#**++***********+++++++++++++++++++++++#@@                                              
       @@#*+++++++++++++++++++++++++******+++++**#@@     %@@@@@@@@@@@@@@@@%                         
     @@#*++++++++++********************#####*+*%@@ %@@%%##****++====+*****##%@@@@                   
   @@@*+++++++******##*******************#####*+#%#***+++++*+=-------******+++**#%@@@               
   @%*++++++*******##%*******************####%%*++++++**##%*==+*#%%##%%%%%%%##*+++**#@@@            
 *@%++++++********##%#********************####%%#++*##%%%%%*#%%%%%%%%%%%%%%%%%%%*----+*#@@@         
 @@++++++********#####**********+**********####%%#+#%%%%%%%%%%###%%%%%%%%%%%%%%#*++=--=+*#@@-       
#@#+++++**********##**###########***++*******###%#+*########*+====+*#############%%#*==+++*#@@      
@@*+++++************##################*+++*****###++######*=-=+**++==#################***+++*%@%    
@@*+++++*********####################%%##*+++*+***+*####*+-+%%%%%@@%*=*####**+=====+*###**++++#@@   
@@*++++*********################**#####%%%#*++++++*####**=*@#**++*#@@*=****+=+*###*+==*****++++#@@  
@@#++++********####****#########****#####%%#*++++*******++%#+**-.=+#@%+****=#%#*#@@@%+=+***+++++#@# 
-@@+++++******##%%#**********##******######%#*++***+++++++#*+-..:-*#@%+***++###-:=#@@@#++***+++++%@+
 #@#+++++******##*****#####************#######*=*******++++*+==+**#@%*+****+++- .=+%@@@*=**++++++*@@
  #@*+++++**************######**+********####*++*++***+*++++*+*#%%@%*+*####+=+--*++%@@@*=+++++++++%@
   @@#+++++****************######*++********+++*******++*+*********+*#######*+***#@@%%#+++++++++++#@
    @@%*++++++***************#####*+++++++++++*************####***##########*****##**+++++++++++++#@
      @@%**+++++****************###*++++++++*************=+*####*###########****+++++++***++++++++#@
         @@%**+++++++++++++++++****++++++++++************=:=##******##########******++++**++++++++%@
            @@%#**++++++++++++++++++***++++++*************-.=#%%##******************+++*+++++++++*%@
               @@@%##************%%**#***+++++************+: :=#%@@@%%%#####+--++********++++++++#@%
                     @@@@@@@@@@@  @#**##**+++++************=:. .:=*#%@@@@@%+::+********+++++++++*@@ 
                                  @@#**###**+++++***********+==-.  .::---::.:+*******++++++++++*@@  
                                   @@#**#%##**+++++**********+===--::......:=******+++++++++++#@@   
                                    @@%**#%%##**+++++*********++=--==-:...:=****++++++++++++*#@@    
                                      @@#**#%%##***++++++*******++===--:-=+*+*+++++++++++++#%@@     
                                        @@#**##%###**++++++***++++++++++++++++++++++++++**%@@       
                                          @@%***#####***++++++++++++++++++++++++++++++*#%@@         
                                            @@@#****###****+++++++++++++++++++++++**#%@@            
                                               @@@%#*******++++++++++++++++++****#%@@               
                                                   @@@%%###*****+++++*****##%%@@@                   
