                                                                                                    
                                                                                                    
                                                                                                    
                                                 .                                                  
                                                 -:                                                 
                                               :----.                                               
                                              .------:                                              
                                             .--------:.                                            
                                            -----------:.                                           
                                          .:-------------                                           
                                          :---------------:                                         
                                       .:------------------.                                        
                                     .:----------------------:                                      
                                   .----------------  ---------:.                                   
                                 :----------------:.  -----------:.                                 
                              .:-----------------:.   :-------------.                               
                            .:----------------...       .......:------:.                            
                          :---------------.                      :------:.                          
                        .-------------:          .       .          .:-----.                        
                       ::-----------.            -.      -:           ...:--:                       
                      .----------:.          .:::         .:.              ---                      
                     :---------:.        .....              .......        .:-:.                    
                     :-------.         ::::::::.            .:::::::.       .---                    
                   .---------.      ...:::::::::..        ..::::::::::.     .---.                   
                   .---------.      .-+ .+:    -+:.      .-+++ .+.    ..    .----.                  
                   .---------.     .*%@-..    .#@*-      +#@@@:..    :+=    .----.                  
                   .---------.       -+@%====*@#+         .+%@@#====++.     .----.                  
                   .---------.         :-------             .-------.      ::----.                  
                   .--------::::.                :::::::::.             :  ------:                  
                   .-------: *@@%+.          .++*@@@@@@@@@%+.         =*@#+.:---.                   
                     ----- :#@@@@@%%*#%%%%###%@@@@@@@@@@@@@@%####%%*#%@@@@@  ---                    
                     .:--- :@@@@@@#+ +@@@@@@@@@@@@@@@@@@@@@@@@@@@#+ +@@@@@@. -:.                    
                       --- :@@@@@@#**+----*@@@@@@@@@@@@@@@@@@@@@@:  +@@@@@@. -                      
                        .: -@@@@@@@@@@%-. :=--------*#######: -:.*%%@@@@@%*                         
                           .=%@@@@@@@@@@%+==@@@@@@@@*+++++++++@+ #@@@@@@@=                          
                             .::=%@@@@@@@@%#=--*%%%%%%%%%@#:::-+#@@@@@@%:                           
                                  =#@@@@@@@@@@@+-         .---+#@@@@@@#=                            
                                    -*@@@@@@@@@@@***+++++++===+#@@@@*-                              
                                      .*%@@@@@@@@@@@+--===+%%%@@@@%.                                
                                        .+%@@@@@@@@@@@@#==*@@@@@@*=                                 
                                          .::::::::::::    ::::::                                   
                                                                                                    
                                                                                                    
                                                                                                    
